heures: hours
comme: such as
présenter: present, introduce, offer
pris: taken
beaux: beautiful, nice, fine
le: the
la: the, there
revêtu: coated
manquer: miss, fail
m'ont: me
où: where
Après: after, afterwards, afterward, next
yeux: eyes
était: was
de: from, of, to, by, with, than
allé: gone
contraire: contrary, opposite, counter
mon: my
moment: time, moment, instant
perdu: lost
Ou: or
sans: without, wanting
demandé: required, in demand, intended
maison: home
classée: classified
année: year, twelvemonth
peut-être: may be, perhaps, maybe
en: in, into, to, at, of
ses: his, its, her
pouvait: could
l'enterrement: burial
allure: appearance, look, pace
condoléances: condolences, bemoaning, grievance
jours: days
quelques: a few
et: and
rouge: red, scarlet, ruddy
est: is, east
deuil: mourning, bereavement, black
peu: little, not very, not much, bit, few
l'asile: asylum
un: a, an, one
sais: know, see, realize
lui: him
cela: it, that
pas: not
Dans: in, into, within, on, inside, aboard
passait: going
les: the, them
que: that, than, whether, which, what, whom, how
elle: she, it, her, herself
refuser: refuse, reject, decline, deny
maman: mom, mum, mummy, mama
temps: time, days, weather, times
porte: door, gateway, gate, doorway
une: a, an, one
verra: will see
plus: more, most, further, plus
aura: aura
hier: yesterday, last night
fera: will do, will make, will take
congé: leave, holiday
pleurait: crying, weeping
c'est: this is
tout: all, any, every, very
C'était: this was
silence: silence, quiet
ce: this, it, that
son: its, his, her, sound
parti: party, part, went away
n'était: was
Mais: but, although, yet
avait: had
avec: with, to, along with
après-demain: day after tomorrow
à: to, in, at, with, by
suis: am
suivre: follow, keep, follow up, pursue
doute: doubt, question
teint: dyed
excuse: excuse, apology, plea
pareille: such, similar, equal
me: me, myself
l'autobus: bus
officielle: official, formal, state
des: of
dans: in, into, within, on
pour: for, to, of
oncle: uncle
sera: will be, will exist
départ: departure, starting, start
Quand: when, whenever
patron: boss, patron, chief
souvent: often
bleu: blue
accompagné: accompanied
dernière: last, latest, latter, final
au: the
il: it, he
presque: almost, nearly, most
pas: not, step, steps
quand: when, whenever, wherever
couru: ran
ne: not
J'ai: I have
deux: two
affaire: case, matter, business
morte: dead woman
clair: clear, light, bright, plain
Aujourd'hui: today, nowadays
Pour: for, to, of
je: I
premiers: first, former, initial, prime
a: to
plutôt: rather, instead
ils: they those
mois: month
si: if, so, whether, that, such, as
Il: it, he
y: there