hommes et les femmes: men and women
je pense que: I think that
collaboration avec: collaboration with
sur le fait que: on the fact that
le nombre de: the number of
pour la premi\xc3\xa8re fois: for the first time
il est difficile de: It is difficult to
ce est la raison pour: This is the reason for
tout ce qui est: all that is
ne faut pas: not required that
parce que: because
en ce qui concerne: with regards to
soumis \xc3\xa0: subject to
du manque de: of the lack of
ne pas manquer: to not miss
du mal \xc3\xa0: to the regret of
un grand nombre de: in big numbers of
du taux de: at the rate of
dizaines de: tens of
ce ne sont pas: these are not
ne sont pas: are not
ne soit pas: is not
de ne pas: of not
ce est la raison pour laquelle: this is the reason for which
tout \xc3\xa0 fait: quite
autrement dit: otherwise said
secteur de la: section of the
\xc3\xa0 ceux qui: to those who
dans le m\xc3\xaame temps: at the same time
tiens \xc3\xa0: hold
est en train de: it is in the process of
en cas de: in the case of
la raison pour laquelle: the reason for which
ne voulons pas: do not want
faire preuve de: does proof of
du point de vue: in the point of view
il n est pas: it is not
la mani\xc3\xa8re dont: the manner of which
je ne veux pas: I do not want
est difficile de: is difficult to
symbole de: symbole of
parvenir \xc3\xa0: to achieve to
ce ne est pas: this is not
il n y a: there is not
raisons pour lesquelles: the reasons for which
envie de: envious of
se permettre de: to permit youself to
certain nombre de: certain numbers of
contribuer \xc3\xa0: to contribute to
trouver une solution: to find a solution
nous ne voulons pas: we do not want
je ne sais pas: I do not know
toutes les: all the
il est possible de: it is possible that
le principe de: the principle the
le manque de: the lack of
le nom de: the name of 
plus en plus: more and more
ne avait pas: did not have
est vrai que: is true that
la plupart des: the most of
mises en: put in
un point de vue: a perspective
en tout cas: in all cases
a beaucoup de: have a lot of
il est n\xc3\xa9cessaire de: it isn't necessary to
esp\xc3\xa9rons que: hope that
ne veut pas: do not want
je ne pense pas: I don't think
\xc3\x80', "l'heure actuelle:
encore une fois: again one more time
la fa\xc3\xa7on dont: the way in which
dans le domaine de la: in the domain of
je lui ai: I have to him
de mettre en place: to put in place
ont montr\xc3\xa9 que: have shown that
ne suis pas: am not
il ne y a pas: there is not
ne serait pas: will not
lutter contre: battle against
est de plus en plus: is more and more
plupart des: most of hte
il ne faut pas: it is not required that
un total de: a total of 
faire pression sur: to put pressure on
ne doit pas: doesn't require
sans aucun doute: without any doubt
je tiens \xc3\xa0: I hold that
plus ou moins: more or less
nous ne devons pas: we do not have to
je ne pense pas que: I don't think
au sujet de: on the subject of
non plus: anymore
convaincu que: convinced that
aujourd hui: today
aujourd'hui: today
tous ceux qui: all of who
quelqu un: someone
nous ne sommes pas: we are not
que il y a: that there is
vous le savez: you know it
depuis plus de: over
aujourd hui: today
que tous les: all
des droits de: the rights of
tous ceux qui: all those
droits de l homme: Human Rights
une s\xc3\xa9rie de: a series of
rien \xc3\xa0 voir avec: nothing to do with
des centaines de: hundreds of
des millions de: millions of
du point de: from the point of
quelque un: someone
nous ne sommes pas: we are not
ne suffit pas: not enough
par rapport \xc3\xa0: compared to
la loi sur les: the Law on
bande de: band
atteinte \xc3\xa0 la: achievement of
la chance de: the chance to
ce est: this is
continuer \xc3\xa0: continue to
les enfants et les: the children and the
que il y a: that there is
vous le savez: you know that
au lieu de: instead of
au mois de: in
est de plus en: is more and more
en m\xc3\xaame temps: together
jusqu \xc3\xa0: just until
je ne suis pas: I'm not
pas dire que: not say
monsieur le pr\xc3\xa9sident: mister president
de moins de: less than
ce ne est: this is not
en ce qui: in
il en va de: so is
conduit \xc3\xa0: pipes to
plus \xc3\xa9lev\xc3\xa9 que:
la seconde guerre: the second world war
de toutes les: of all the
faire quelque chose: do something
marge de:
une sorte de: a form of
la lutte contre: the fight against
ce ne sont: these aren't
mise en: setting
manque de: lack of
surface de: surface of
le un des: one of
comme vous le savez: as you know
ce ne est pas: this is not
consiste \xc3\xa0: consists of
essay\xc3\xa9 de: try to
il est vrai que: it is true that
au sein de: in
au nom de: on behalf of
entr\xc3\xa9e en vigueur: come in force
mais il y a: but there is
une partie de: a part of
une plus grande: greater
il y a: there is
pour lutter contre: to fight against
ne sommes pas: are not
la n\xc3\xa9cessit\xc3\xa9 de: the necessity of
afin de: in order to
la libre circulation:
que ce est: that is
taux de: rate of
de de la: of
ne devons pas: should not
de plus en plus: more and more
n\xc3\xa9cessit\xc3\xa9 de: necessity of
bon nombre de: good name of
ceux qui: those
ne est pas: isn't
ne pense pas: don't think
tandis que: while
capable de: capable of